█████████████████████████████████████
█                           █   █►$◀︎█
D           █               █ █ █►$◀︎█
█           █               █ █ █►$◀︎█
█           ████████        █ █ █► ◀︎█
█                           █ █ █► ◀︎█
█                           █ █ █► ◀︎█
█                             █    ◀︎█
███████████████████████████████    ◀︎█
█                                  ◀︎█
█ ♨︎B        B                      ◀︎█
█                                  ◀︎█
█████████████████████████████████████
             █  ♨︎  █
             █ $$$ █ 
             ███C███