█████C███████████████████████
█           █   $           █
█           █               █
█           ████████        █
█ B B B █                   █
█ $ $ $ █           B       █
█ $ $ $ █                   █
█████████████████████████████